EA ./pics/bbischof.xpm
NO ./pics/bbischof.xpm
SO ./pics/bbischof.xpm
WE ./pics/bbischof.xpm

F 120,120,120
C 120,120,230

1111111111111111111111111111111
1000000000000000000000000000001
1000000000N0000000000000000000001
1000000000000000000000000000001
1000000000000000000000000000001
1111111111111111111111111111111
