EA ./pics/gw110.xpm
NO ./pics/azanane.xpm
SO ./pics/mossy.xpm
WE ./pics/bluestone.xpm

F 120,120,120
C 120,120,230

1111111111
1N00000001
1111000001
1000000001
1000001001
1000001001
100000100111111111
111111100000000001
      100000000001
      100000000001
      100001110111
      100001000001
      100001000001
      111111111111
