NO ./pics/bbischof.xpm
SO ./pics/bbischof.xpm
WE ./pics/bbischof.xpm
EA ./pics/bbischof.xpm
F 120,120,120
C 120,120,230

1111
1001
1N01
1111
