NO ./pics/bbischof.xpm
SO ./pics/bbischof.xpm
WE ./pics/bbischof.xpm
EA ./pics/bbischof.xpm
F 120,120,120
C 120,120,230

111111111111111111111111111111111111111111111111111111111111111111111111111111111111111111111111111111
100000000000000000000000000000000000000000000000000000000000000000000000000000000000000000000000000001
100000000000000000000000000000000000000000000000000000000000000000000000000000000000000000000000000N01
100000000010000000000000000000000000000000000000000000000000100000000000000000000000000000000100000001
100000000000000000000000000000000000000000000000000000000000000000000000000000000000000000000000000001
100000000000000000000000000000000000000000000000000000000000000000000000000000000000000000000000000001
100000000000000000000000000000000000000000000000000000000000000000000000000000000000000000000000000001
100000000010000000000000000000000000000000000000000000000000100000000000000000000000000000000100000001
100000000000000000000000000000000000000000000000000000000000000000000000000000000000000000000000000001
100000000000000000000000000000000000000000000000000000000000000000000000000000000000000000000000000001
100000000000000000000000000000000000000000000000000000000000000000000000000000000000000000000000000001
100000000000000000000000000000000000000000000000000000000000000000000000000000000000000000000000000001
100000000000000000000000000000000000000000000000000000000000000000000000000000000000000000000000000001
100000000010000000000000000000000000000000000000000000000000100000000000000000000000000000000100000001
100000000000000000000000000000000000000000000000000000000000000000000000000000000000000000000000000001
100000000000000000000000000000000000000000000000000000000000000000000000000000000000000000000000000001
100000000000000000000000000000000000000000000000000000000000000000000000000000000000000000000000000001
100000000001111111111111111111111111111111111111111111111111111111111111111111110000000000000000000001
100000000001111111111111111111111111111111111111111111111111111111111111111111110000000000000000000001
100000000000000000111000000000000000111000000000000001110000000000000011100000000000000000000000000001
100000000000000000111000000000000000111000000000000001110000000000000011100000000000000000000000000001
100000000010000000111000000000000000111000000000000001110000000000000011100000000000000000100000000001
100000000000000000111000000000000000111000000000000001110000000000000011100000000000000000000000000001
100000000000000000111000000000000000111000000000000001110000000000000011100000000000000000000000000001
100000000000000000111000000000000000111000000000000001110000000000000011100000000000000000000000000001
100000000000000000000000000000000000000000000000000000000000000000000000000000000000000000000000000001
100000000000000000000000000000000000000000000000000000000000000000000000000000000000000000000000000001
100000000000000000000000000000000000000000000000000000000000000000000000000000000000000000000000000001
100000000010000000000000000000000000000000000000000000000000100000000000000000000000000000000100000001
100000000000000000000000000000000000000000000000000000000000000000000000000000000000000000000000000001
100000000000000000000000000000000000000000000000000000000000000000000000000000000000000000000000000001
100000000000000000000000000000000000000000000000000000000000000000000000000000000000000000000000000001
100000000000000000000000000000000000000000000000000000000000000000000000000000000000000000000000000001
100000000000000000000000000000000000000000000000000000000000000000000000000000000000000000000000000001
100000000000000000000000000000000000000000000000000000000000000000000000000000000000000000000000000001
100000000010000000000000000000000000000000000000000000000000100000000000000000000000000000000100000001
100000000000000000000000000000000000000000000000000000000000000000000000000000000000000000000000000001
100000000000000000000000000000000000000000000000000000000000000000000000000000000000000000000000000001
100000000000000000000000000000000000000000000000000000000000000000000000000000000000000000000000000001
100000000000000000000000000000000000000000000000000000000000000000000000000000000000000000000000000001
111111111111111111111111111111111111111111111111111111111111111111111111111111111111111111111111111111

