NO ./pics/tarch.xpm
SO ./pics/tarch.xpm
WE ./pics/tarch.xpm
EA ./pics/tarch.xpm
F 120,120,120
C 120,120,230

1111111111111111111111111111111111111111111111111111111111111111111111111111111111111111111111111111
1000N00000000001111111111111110000000000000000000000000000000000000000000000000000000000000000000001
1000000000000001             10000000000000000000000000000000000000000000000000000000000000000000001
1000000000100001             10000000000000000000000000000001000000000000000000000000000000000000001
1000000000000001             10000000000000000000000000000000000000000000000000000000000000000000001
1000000000000001             10000000000000000000000000000000000000000000000000000000000000000000001
1000000000000001111111111111110000000000000000000000000000000000000000000000000000000000000000000001
1000000000100000000000000000000000000000000000000000000000001000000000000000000000000000000000000001
1000000000000000000000000000000000000000000000000000000000000000000000000000000000000000000000000001
1000000000000000000000000000000000000000000000000000000000000000000000000000000000000000000000000001
1000000000000000000000000000000000000000000000000000000000000000000000000000000000000000000000000001
1000000000000000000000000000000000000000000000000000000000000000000000000000000000000000000000000001
1000000000000000000000000000000000000000000000000000000000000000000000000000000000000000000000000001
1000000000100000000000000000000000000000000000000000000000001000000000000000000000000000000000000001
1000000000000000000000000000000000000000000000000000000000000000000000000000000000000000000000000001
1000000000000000000000000000000000000000000000000000000000000000000000000000000000000000000000000001
1000000000000000000000000000000000000000000000000000000000000000000000000000000000000000000000000001
1000000000011111111111111111111111111111111111111111111111111111111111111111111100000000000000000001
1000000000011111111111111111111111111111111111111111111111111111111111111111111100000000000000000001
1000000000000000001110000000000000001110000000000000011100000000000000111000000000000000000000000001
1000000000000000001110000000000000001110000000000000011100000000000000111000000000000000000000000001
1000000000100000001110000000000000001110000000000000011100000000000000111000000000000000001000000001
1000000000000000001110000000000000001110000000000000011100000000000000111000000000000000000000000001
1000000000000000001110000000000000001110000000000000011100000000000000111000000000000000000000000001
1000000000000000001110000000000000001110000000000000011100000000000000111000000000000000000000000001
1000000000000000000000000000000000000000000000000000000000000000000000000000000000000000000000000001
1000000000000000000000000000000000000000000000000000000000000000000000000000000000000000000000000001
1000000000000000000000000000000000000000000000000000000000000000000000000000000000000000000000000001
1000000000100000000000000000000000000000000000000000000000001000000000000000000000000000000000000001
1000000000000000000000000000000000000000000000000000000000000000000000000000000000000000000000000001
1000000000000000000000000000000000000000000000000000000000000000000000000000000000000000000000000001
1000000000000000000000000000000000000000000000000000000000000000000000000000000000000000000000000001
1000000000000000000000000000000000000000000000000000000000000000000000000000000000000000000000000001
1000000000000000000000000000000000000000000000000000000000000000000000000000000000000000000000000001
1000000000100000000000000000000000000000000000000000000000001000000000000000000000000000000000000001
1000000000000000000000000000000000000000000000000000000000000000000000000000000000000000000000000001
1000000000000000000000000000000000000000000000000000000000000000000000000000000000000000000000000001
1000000000000000000000000000000000000000000000000000000000000000000000000000000000000000000000000001
1000000000000000000000000000000000000000000000000000000000000000000000000000000000000000000000000001
1111111111111111111111111111111111111111111111111111111111111111111111111111111111111111111111111111