NO ./pics/bbischof.xpm
SO ./pics/bbischof.xpm
WE ./pics/bbischof.xpm
EA ./pics/bbischof.xpm
F 120,120,120
C 120,120,230

11111111111
11N10000001
11110000001
10000000001
10000000001
10000000001
11111111111